 *****   *****    *****
 *       *    *   *    
 *****   *    *   *****
 *       *    *   *    
 *       *****    *    